k i m u l i	k i m u l i
n u p u ɹ u	n u p u ɹ u
b e g i l i	b e g i l i
t u b u ɹ u	t u b u ɹ u
b e g i ɹ u	b e g i ɹ u
n e n u ɹ u	n e n u ɹ u
g u n u l i	g u n u l i
k i m u ɹ u	k i m u ɹ u
t u b u l i	t u b u l i
g u n u ɹ u	g u n u ɹ u
d e t u ɹ u	d e t u ɹ u
d e t u l i	d e t u l i
n e g o ɹ u	n e g o ɹ u
n e g o l i	n e g o l i
n e n u l i	n e n u l i
n u p u l i	n u p u l i
d i k u L i l i	d i k u ɹ i l i
d e n i t o l i	d e n i t o l i
g e t o L i ɹ u	g e t o l i ɹ u
n i g o L i l i	n i g o ɹ i l i
k e g e p o l i	k e g e p o l i
t e m o L u ɹ u	t e m o l u ɹ u
m o b i b u l i	m o b i b u l i
n i g o L i ɹ u	n i g o l i ɹ u
k o m i L e ɹ u	k o m i l e ɹ u
g o t u p e l i	g o t u p e l i
n o b i m i ɹ u	n o b i m i ɹ u
g u p u L u l i	g u p u ɹ u l i
n i b o L e l i	n i b o ɹ e l i
m e p u L i ɹ u	m e p u l i ɹ u
k u m i b u ɹ u	k u m i b u ɹ u
t e b i L u l i	t e b i ɹ u l i
n o g o L e ɹ u	n o g o l e ɹ u
t u d o L o ɹ u	t u d o l o ɹ u
g o t o t u l i	g o t o t u l i
k u k i L i l i	k u k i ɹ i l i
d u b u d o ɹ u	d u b u d o ɹ u
d i n i L e l i	d i n i ɹ e l i
k e d i L o l i	k e d i ɹ o l i
b u n o L i ɹ u	b u n o l i ɹ u
b e g e t i l i	b e g e t i l i
d u g e n u ɹ u	d u g e n u ɹ u
n o t u L o ɹ u	n o t u l o ɹ u
b i p i L e ɹ u	b i p i l e ɹ u
m o t i L e l i	m o t i ɹ e l i
g o p e g i l i	g o p e g i l i
k u g i m u ɹ u	k u g i m u ɹ u
g o b i L e l i	g o b i ɹ e l i
d o d e n e l i	d o d e n e l i
n i m o L o ɹ u	n i m o l o ɹ u
t u k e n u ɹ u	t u k e n u ɹ u
p u m o L i ɹ u	p u m o l i ɹ u
n u t o L e l i	n u t o ɹ e l i
d i n u p u ɹ u	d i n u p u ɹ u
p i p i b e ɹ u	p i p i b e ɹ u
d i g i L u ɹ u	d i g i l u ɹ u
p i n e n o ɹ u	p i n e n o ɹ u
n i b o L e ɹ u	n i b o l e ɹ u
g o d u d u l i	g o d u d u l i
g i g o L i ɹ u	g i g o l i ɹ u
m o k o m i l i	m o k o m i l i
k i g e p o l i	k i g e p o l i
p i n e n o l i	p i n e n o l i
m i k e k e l i	m i k e k e l i
t u d u k i l i	t u d u k i l i
g e m o L i l i	g e m o ɹ i l i
g o t o t u ɹ u	g o t o t u ɹ u
b o t o p i l i	b o t o p i l i
g i d e k o ɹ u	g i d e k o ɹ u
m o k o m i ɹ u	m o k o m i ɹ u
p o k e L u l i	p o k e ɹ u l i
t i b u k o ɹ u	t i b u k o ɹ u
t o p o t o l i	t o p o t o l i
d i n u p u l i	d i n u p u l i
d o p u p u l i	d o p u p u l i
g i d e p o l i	g i d e p o l i
n i d e L e ɹ u	n i d e l e ɹ u
d i b i p e l i	d i b i p e l i
t u g i L o ɹ u	t u g i l o ɹ u
n u n u p u ɹ u	n u n u p u ɹ u
m o n u n e l i	m o n u n e l i
b u t u L o l i	b u t u ɹ o l i
g i m i L e ɹ u	g i m i l e ɹ u
n e b e b u l i	n e b e b u l i
t u d u k i ɹ u	t u d u k i ɹ u
n o d u L u ɹ u	n o d u l u ɹ u
d i n i L e ɹ u	d i n i l e ɹ u
p i g i p o l i	p i g i p o l i
p e p o L i ɹ u	p e p o l i ɹ u
g o n o d e ɹ u	g o n o d e ɹ u
g e k u L o ɹ u	g e k u l o ɹ u
d e k e L i l i	d e k e ɹ i l i
m e p e L e ɹ u	m e p e l e ɹ u
g o p i k u l i	g o p i k u l i
t o b o L e ɹ u	t o b o l e ɹ u
p u m o L e l i	p u m o ɹ e l i
b i p e m i ɹ u	b i p e m i ɹ u
d u p i n u l i	d u p i n u l i
n e b e b u ɹ u	n e b e b u ɹ u
g i d i p e ɹ u	g i d i p e ɹ u
k o d o L i ɹ u	k o d o l i ɹ u
n o t u L o l i	n o t u ɹ o l i
m u k i L e ɹ u	m u k i l e ɹ u
d e n i t o ɹ u	d e n i t o ɹ u
t o d u L e l i	t o d u ɹ e l i
g e k u L o l i	g e k u ɹ o l i
p i p i b e l i	p i p i b e l i
p u m o L i l i	p u m o ɹ i l i
p e m i L e ɹ u	p e m i l e ɹ u
b e p o g u l i	b e p o g u l i
n i p u L e ɹ u	n i p u l e ɹ u
g o p i k u ɹ u	g o p i k u ɹ u
t e g u d e l i	t e g u d e l i
g o d i t i l i	g o d i t i l i
m i t u L u ɹ u	m i t u l u ɹ u
g e t o L i l i	g e t o ɹ i l i
k u m i b u l i	k u m i b u l i
k e n i p o l i	k e n i p o l i
k e p i k o ɹ u	k e p i k o ɹ u
p i n i L u ɹ u	p i n i l u ɹ u
t e t u d e l i	t e t u d e l i
n u g i L i ɹ u	n u g i l i ɹ u
t u t e L i ɹ u	t u t e l i ɹ u
m i m o L u ɹ u	m i m o l u ɹ u
k e n i p o ɹ u	k e n i p o ɹ u
n e g e L i ɹ u	n e g e l i ɹ u
g o p e g i ɹ u	g o p e g i ɹ u
d i n o L e l i	d i n o ɹ e l i
g i m i L e l i	g i m i ɹ e l i
b e b u L i ɹ u	b e b u l i ɹ u
p u m e g o l i	p u m e g o l i
g i g o L i l i	g i g o ɹ i l i
t i b u k o l i	t i b u k o l i
n i n e d e ɹ u	n i n e d e ɹ u
g i p e d i l i	g i p e d i l i
n o m o L u ɹ u	n o m o l u ɹ u
k u g i m u l i	k u g i m u l i
d i b i p e ɹ u	d i b i p e ɹ u
d e k e L i ɹ u	d e k e l i ɹ u
p u t i L u ɹ u	p u t i l u ɹ u
k i d i L o ɹ u	k i d i l o ɹ u
b i p i L e l i	b i p i ɹ e l i
k i g e p o ɹ u	k i g e p o ɹ u
d i g e m i l i	d i g e m i l i
m e p e L e l i	m e p e ɹ e l i
k e b e g e ɹ u	k e b e g e ɹ u
p e d e L o ɹ u	p e d e l o ɹ u
d i g e m i ɹ u	d i g e m i ɹ u
d e t o L e ɹ u	d e t o l e ɹ u
m i m i L u ɹ u	m i m i l u ɹ u
d u p i n u ɹ u	d u p i n u ɹ u
t u d u g i ɹ u	t u d u g i ɹ u
m u d o L e ɹ u	m u d o l e ɹ u
t i p e L e ɹ u	t i p e l e ɹ u
d i g i L u l i	d i g i ɹ u l i
k u g o p e ɹ u	k u g o p e ɹ u
b u n o L e l i	b u n o ɹ e l i
n o t o d e ɹ u	n o t o d e ɹ u
b o p o L o ɹ u	b o p o l o ɹ u
p e k o L o ɹ u	p e k o l o ɹ u
b u b o L u l i	b u b o ɹ u l i
t o d u L e ɹ u	t o d u l e ɹ u
n i g u n o ɹ u	n i g u n o ɹ u
n u m i L u l i	n u m i ɹ u l i
t u g i L o l i	t u g i ɹ o l i
d i n i L i ɹ u	d i n i l i ɹ u
g u n e t o ɹ u	g u n e t o ɹ u
t o p o t o ɹ u	t o p o t o ɹ u
t u t u m e ɹ u	t u t u m e ɹ u
g i g u L i l i	g i g u ɹ i l i
b i n u g u ɹ u	b i n u g u ɹ u
p u m o L e ɹ u	p u m o l e ɹ u
m u k i L e l i	m u k i ɹ e l i
m o p u d i ɹ u	m o p u d i ɹ u
k o d u g i l i	k o d u g i l i
n e m i L i l i	n e m i ɹ i l i
t e b e g o l i	t e b e g o l i
t u t u m e l i	t u t u m e l i
d u t e L i l i	d u t e ɹ i l i
g o d i t i ɹ u	g o d i t i ɹ u
m e k i p u l i	m e k i p u l i
n i g i L i ɹ u	n i g i l i ɹ u
t o m i L e l i	t o m i ɹ e l i
g i m u L u l i	g i m u ɹ u l i
g o k o m u ɹ u	g o k o m u ɹ u
k u b o k u l i	k u b o k u l i
d o d u b o l i	d o d u b o l i
b e d i b o ɹ u	b e d i b o ɹ u
p i g i p o ɹ u	p i g i p o ɹ u
t e m e d i l i	t e m e d i l i
n o m o L u l i	n o m o ɹ u l i
b u n o L e ɹ u	b u n o l e ɹ u
t i p e L e l i	t i p e ɹ e l i
n o t o d e l i	n o t o d e l i
b e d u L e l i	b e d u ɹ e l i
b i p i L i ɹ u	b i p i l i ɹ u
b i n u g u l i	b i n u g u l i
n u t o L e ɹ u	n u t o l e ɹ u
b e p e L o l i	b e p e ɹ o l i
n e m i L i ɹ u	n e m i l i ɹ u
b u t i L o l i	b u t i ɹ o l i
d i k u L i ɹ u	d i k u l i ɹ u
k u g o p e l i	k u g o p e l i
b e d u L e ɹ u	b e d u l e ɹ u
m o b u g i l i	m o b u g i l i
m i m i L u l i	m i m i ɹ u l i
g i d i p e l i	g i d i p e l i
g o p e L e l i	g o p e ɹ e l i
m i g u n e l i	m i g u n e l i
k i d i L o l i	k i d i ɹ o l i
d i g i m u ɹ u	d i g i m u ɹ u
k u k i L i ɹ u	k u k i l i ɹ u
g u n e t o l i	g u n e t o l i
g u b o g e l i	g u b o g e l i
m u k o b e ɹ u	m u k o b e ɹ u
g i d e k o l i	g i d e k o l i
m e p u k e ɹ u	m e p u k e ɹ u
g e b i m e l i	g e b i m e l i
n i p u L e l i	n i p u ɹ e l i
d o t e L o ɹ u	d o t e l o ɹ u
b u k i k u ɹ u	b u k i k u ɹ u
t u n i L i ɹ u	t u n i l i ɹ u
m e t u t o ɹ u	m e t u t o ɹ u
k u t o m o l i	k u t o m o l i
g o t u p e ɹ u	g o t u p e ɹ u
b e n o m o ɹ u	b e n o m o ɹ u
t u n i L i l i	t u n i ɹ i l i
p o n o L u l i	p o n o ɹ u l i
n i t e t i ɹ u	n i t e t i ɹ u
k o d o L i l i	k o d o ɹ i l i
t e g u d e ɹ u	t e g u d e ɹ u
k e d i L o ɹ u	k e d i l o ɹ u
g e b i m e ɹ u	g e b i m e ɹ u
b e g e t i ɹ u	b e g e t i ɹ u
b u t i L o ɹ u	b u t i l o ɹ u
m u m e k o l i	m u m e k o l i
d o p o m o l i	d o p o m o l i
b e d o g i l i	b e d o g i l i
b i p i d u l i	b i p i d u l i
k u b o k u ɹ u	k u b o k u ɹ u
t e m e d i ɹ u	t e m e d i ɹ u
t e b i L u ɹ u	t e b i l u ɹ u
n i g u n o l i	n i g u n o l i
b o d u L e l i	b o d u ɹ e l i
n u n u p u l i	n u n u p u l i
k e b e g e l i	k e b e g e l i
m i t u L u l i	m i t u ɹ u l i
t u d o L o l i	t u d o ɹ o l i
n u g i L i l i	n u g i ɹ i l i
g i p e d i ɹ u	g i p e d i ɹ u
t u k e n u l i	t u k e n u l i
m i g u n e ɹ u	m i g u n e ɹ u
d o d u m o ɹ u	d o d u m o ɹ u
g i d e p o ɹ u	g i d e p o ɹ u
g o p e L e ɹ u	g o p e l e ɹ u
p u t o L u l i	p u t o ɹ u l i
g u b o g e ɹ u	g u b o g e ɹ u
g e m o L i ɹ u	g e m o l i ɹ u
b i p e m i l i	b i p e m i l i
b e t o g e l i	b e t o g e l i
n u b i L o ɹ u	n u b i l o ɹ u
p e k o L o l i	p e k o ɹ o l i
b e b u L i l i	b e b u ɹ i l i
d o p o m o ɹ u	d o p o m o ɹ u
n o d u L u l i	n o d u ɹ u l i
m e t u t o l i	m e t u t o l i
p o n e L e l i	p o n e ɹ e l i
t e n u L u ɹ u	t e n u l u ɹ u
b e p e L i l i	b e p e ɹ i l i
p u t o L u ɹ u	p u t o l u ɹ u
t e b e g o ɹ u	t e b e g o ɹ u
m u n e g o ɹ u	m u n e g o ɹ u
p o n e L e ɹ u	p o n e l e ɹ u
k e p i k o l i	k e p i k o l i
t u t e L i l i	t u t e ɹ i l i
m u d o L e l i	m u d o ɹ e l i
g i k i n o l i	g i k i n o l i
n o b i m i l i	n o b i m i l i
d u m i L i l i	d u m i ɹ i l i
b o p o L o l i	b o p o ɹ o l i
p e p o L i l i	p e p o ɹ i l i
b e p e L o ɹ u	b e p e l o ɹ u
n i m o L o l i	n i m o ɹ o l i
d o t e L o l i	d o t e ɹ o l i
p u t i L u l i	p u t i ɹ u l i
d o b e k i l i	d o b e k i l i
t o m i L e ɹ u	t o m i l e ɹ u
d o b e k i ɹ u	d o b e k i ɹ u
m o t i L e ɹ u	m o t i l e ɹ u
n i n e d e l i	n i n e d e l i
g i t i L u l i	g i t i ɹ u l i
t e n u L u l i	t e n u ɹ u l i
t e t u d e ɹ u	t e t u d e ɹ u
g i t i L u ɹ u	g i t i l u ɹ u
t e b i L o ɹ u	t e b i l o ɹ u
g o b i L e ɹ u	g o b i l e ɹ u
d o p u p u ɹ u	d o p u p u ɹ u
p o k e L u ɹ u	p o k e l u ɹ u
b u k i k u l i	b u k i k u l i
k i p u L o l i	k i p u ɹ o l i
d u b u d o l i	d u b u d o l i
m e b u m e l i	m e b u m e l i
n u b i L o l i	n u b i ɹ o l i
p e p o L o ɹ u	p e p o l o ɹ u
n i n o g e l i	n i n o g e l i
b i k e b e ɹ u	b i k e b e ɹ u
n e g e L i l i	n e g e ɹ i l i
d i k u b u l i	d i k u b u l i
p e m i L e l i	p e m i ɹ e l i
d o d u b o ɹ u	d o d u b o ɹ u
b i p i L i l i	b i p i ɹ i l i
n i m i p u ɹ u	n i m i p u ɹ u
g u b u L i l i	g u b u ɹ i l i
m e p u L i l i	m e p u ɹ i l i
d i n o L e ɹ u	d i n o l e ɹ u
d i n i L i l i	d i n i ɹ i l i
m e p u k e l i	m e p u k e l i
t u d u g i l i	t u d u g i l i
p u m e g o ɹ u	p u m e g o ɹ u
m e k i p u ɹ u	m e k i p u ɹ u
p e p o L o l i	p e p o ɹ o l i
t u m e t i ɹ u	t u m e t i ɹ u
g u p u L u ɹ u	g u p u l u ɹ u
b i k e b e l i	b i k e b e l i
m u m e k o ɹ u	m u m e k o ɹ u
n o g o L e l i	n o g o ɹ e l i
d e t o L e l i	d e t o ɹ e l i
d u k u L i ɹ u	d u k u l i ɹ u
b o d u L e ɹ u	b o d u l e ɹ u
b e d i b o l i	b e d i b o l i
k o p i g e l i	k o p i g e l i
k i p u L o ɹ u	k i p u l o ɹ u
n u g u L e ɹ u	n u g u l e ɹ u
b u b o L u ɹ u	b u b o l u ɹ u
b e t o g e ɹ u	b e t o g e ɹ u
d i k u b u ɹ u	d i k u b u ɹ u
n i n o g e ɹ u	n i n o g e ɹ u
m u n e g o l i	m u n e g o l i
t e b i L o l i	t e b i ɹ o l i
b e n o m o l i	b e n o m o l i
t e m o L u l i	t e m o ɹ u l i
g o n o d e l i	g o n o d e l i
n u g u L e l i	n u g u ɹ e l i
d i g i m u l i	d i g i m u l i
n u m i L u l i	n u m i ɹ u l i
t u m e t i l i	t u m e t i l i
m u k o b e l i	m u k o b e l i
p e d e L o l i	p e d e ɹ o l i
b e p o g u ɹ u	b e p o g u ɹ u
m e b u m e ɹ u	m e b u m e ɹ u
p o n i L o l i	p o n i ɹ o l i
p o t i m o ɹ u	p o t i m o ɹ u
t e n i L i ɹ u	t e n i l i ɹ u
k u t o m o ɹ u	k u t o m o ɹ u
m e n e m u ɹ u	m e n e m u ɹ u
d u t e L i ɹ u	d u t e l i ɹ u
g i n o p i l i	g i n o p i l i
b e d o g i ɹ u	b e d o g i ɹ u
n i d e L e l i	n i d e ɹ e l i
b e p e L i ɹ u	b e p e l i ɹ u
g u b u L i ɹ u	g u b u l i ɹ u
b u n o L i l i	b u n o ɹ i l i
k e g e p o ɹ u	k e g e p o ɹ u
p i n i L u l i	p i n i ɹ u l i
k o m i L e l i	k o m i ɹ e l i
m o b i b u ɹ u	m o b i b u ɹ u
g i n o p i ɹ u	g i n o p i ɹ u
g o d u d u ɹ u	g o d u d u ɹ u
m e n e m u l i	m e n e m u l i
p o t i m o l i	p o t i m o l i
m i m o L u l i	m i m o ɹ u l i
b i p i d u ɹ u	b i p i d u ɹ u
m o b u g i ɹ u	m o b u g i ɹ u
d o d u m o l i	d o d u m o l i
d u k u L i l i	d u k u ɹ i l i
b u t u L o ɹ u	b u t u l o ɹ u
n i m i p u l i	n i m i p u l i
m o p u d i l i	m o p u d i l i
g i g u L i ɹ u	g i g u l i ɹ u
m o n u n e ɹ u	m o n u n e ɹ u
n u m i L u ɹ u	n u m i l u ɹ u
b o t o p i ɹ u	b o t o p i ɹ u
m i k e k e ɹ u	m i k e k e ɹ u
d u g e n u l i	d u g e n u l i
g o k o m u l i	g o k o m u l i
g i k i n o ɹ u	g i k i n o ɹ u
n u m i L u ɹ u	n u m i l u ɹ u
g i m u L u ɹ u	g i m u l u ɹ u
b e g e L e ɹ u	b e g e l e ɹ u
n i g i L i l i	n i g i ɹ i l i
t o b o L e l i	t o b o ɹ e l i
p o n i L o ɹ u	p o n i l o ɹ u
k o d u g i ɹ u	k o d u g i ɹ u
p o n o L u ɹ u	p o n o l u ɹ u
d u m i L i ɹ u	d u m i l i ɹ u
t e n i L i l i	t e n i ɹ i l i
d o d e n e ɹ u	d o d e n e ɹ u
n i t e t i l i	n i t e t i l i
k o p i g e ɹ u	k o p i g e ɹ u
b e g e L e l i	b e g e ɹ e l i
