k i m u l i	k i m u l i
n u p u ɹ u	n u p u ɹ u
b e g i l i	b e g i l i
t u b u ɹ u	t u b u ɹ u
b e g i ɹ u	b e g i ɹ u
n e n u ɹ u	n e n u ɹ u
g u n u l i	g u n u l i
k i m u ɹ u	k i m u ɹ u
t u b u l i	t u b u l i
g u n u ɹ u	g u n u ɹ u
d e t u ɹ u	d e t u ɹ u
d e t u l i	d e t u l i
n e g o ɹ u	n e g o ɹ u
n e g o l i	n e g o l i
n e n u l i	n e n u l i
n u p u l i	n u p u l i
d i L u k i l i	d i l u k i l i
d e L o t e l i	d e l o t e l i
g e b i m e ɹ u	g e b i m e ɹ u
n i L o g i l i	n i l o g i l i
k e g e p o l i	k e g e p o l i
t e b e g o ɹ u	t e b e g o ɹ u
m o L i t e l i	m o l i t e l i
n i L o g i ɹ u	n i ɹ o g i ɹ u
k o d u g i ɹ u	k o d u g i ɹ u
g o t u p e l i	g o t u p e l i
n o L o g e ɹ u	n o ɹ o g e ɹ u
g u n e t o l i	g u n e t o l i
n i L e d e l i	n i l e d e l i
m e n e m u ɹ u	m e n e m u ɹ u
k u m i b u ɹ u	k u m i b u ɹ u
t e L i n i l i	t e l i n i l i
n o L u d u ɹ u	n o ɹ u d u ɹ u
t u L e t i ɹ u	t u ɹ e t i ɹ u
g o t o t u l i	g o t o t u l i
k u g o p e l i	k u g o p e l i
d u L e t i ɹ u	d u ɹ e t i ɹ u
d i g e m i l i	d i g e m i l i
k e b e g e l i	k e b e g e l i
b u L o n i ɹ u	b u ɹ o n i ɹ u
b e d i b o l i	b e d i b o l i
d u L i m i ɹ u	d u ɹ i m i ɹ u
n o t o d e ɹ u	n o t o d e ɹ u
b i n u g u ɹ u	b i n u g u ɹ u
m o p u d i l i	m o p u d i l i
g o p e g i l i	g o p e g i l i
k u b o k u ɹ u	k u b o k u ɹ u
g o L e p e l i	g o l e p e l i
d o b e k i l i	d o b e k i l i
n i g u n o ɹ u	n i g u n o ɹ u
t u d u g i ɹ u	t u d u g i ɹ u
p u L o m i ɹ u	p u ɹ o m i ɹ u
n u n u p u l i	n u n u p u l i
d i n u p u ɹ u	d i n u p u ɹ u
p i p i b e ɹ u	p i p i b e ɹ u
d i L i n i ɹ u	d i ɹ i n i ɹ u
p i g i p o ɹ u	p i g i p o ɹ u
n i L e d e ɹ u	n i ɹ e d e ɹ u
g o d i t i l i	g o d i t i l i
g i L u g i ɹ u	g i ɹ u g i ɹ u
m o b u g i l i	m o b u g i l i
k i L u p o l i	k i l u p o l i
p i g i p o l i	p i g i p o l i
m i L o m u l i	m i l o m u l i
t u L i n i l i	t u l i n i l i
g e L u k o l i	g e l u k o l i
g o t o t u ɹ u	g o t o t u ɹ u
b o t o p i l i	b o t o p i l i
g i L i m e ɹ u	g i ɹ i m e ɹ u
m o b u g i ɹ u	m o b u g i ɹ u
p o L e k u l i	p o l e k u l i
t i L e p e ɹ u	t i ɹ e p e ɹ u
t o p o t o l i	t o p o t o l i
d i n u p u l i	d i n u p u l i
d o p o m o l i	d o p o m o l i
g i L i t u l i	g i l i t u l i
n i L i g i ɹ u	n i ɹ i g i ɹ u
d i L i g u l i	d i l i g u l i
t u L o d o ɹ u	t u ɹ o d o ɹ u
n u L u g e ɹ u	n u ɹ u g e ɹ u
m o k o m i l i	m o k o m i l i
b u k i k u l i	b u k i k u l i
g i d e p o ɹ u	g i d e p o ɹ u
n e L e g i l i	n e l e g i l i
t u L i n i ɹ u	t u ɹ i n i ɹ u
n o L o m u ɹ u	n o ɹ o m u ɹ u
d i g e m i ɹ u	d i g e m i ɹ u
p i L i n u l i	p i l i n u l i
p e L o p i ɹ u	p e ɹ o p i ɹ u
g o k o m u ɹ u	g o k o m u ɹ u
g e L o t i ɹ u	g e ɹ o t i ɹ u
d e L e k i l i	d e l e k i l i
m e k i p u ɹ u	m e k i p u ɹ u
g o p i k u l i	g o p i k u l i
t o L i m e ɹ u	t o ɹ i m e ɹ u
p u L o m e l i	p u l o m e l i
b i k e b e ɹ u	b i k e b e ɹ u
d u g e n u l i	d u g e n u l i
n e L e g i ɹ u	n e ɹ e g i ɹ u
g i L o g i ɹ u	g i ɹ o g i ɹ u
k o L i m e ɹ u	k o ɹ i m e ɹ u
n o t o d e l i	n o t o d e l i
m u L o d e ɹ u	m u ɹ o d e ɹ u
d e L o t e ɹ u	d e ɹ o t e ɹ u
t o L o b e l i	t o l o b e l i
g e L o t i l i	g e l o t i l i
p i p i b e l i	p i p i b e l i
p u L o m i l i	p u l o m i l i
p e L o k o ɹ u	p e ɹ o k o ɹ u
b e p o g u l i	b e p o g u l i
n i n o g e ɹ u	n i n o g e ɹ u
g o p i k u ɹ u	g o p i k u ɹ u
t e L o m u l i	t e l o m u l i
g o L i b e l i	g o l i b e l i
m i k e k e ɹ u	m i k e k e ɹ u
g e b i m e l i	g e b i m e l i
k u m i b u l i	k u m i b u l i
k e n i p o l i	k e n i p o l i
k e p i k o ɹ u	k e p i k o ɹ u
p i n e n o ɹ u	p i n e n o ɹ u
t e t u d e l i	t e t u d e l i
n u L i g i ɹ u	n u ɹ i g i ɹ u
t u m e t i ɹ u	t u m e t i ɹ u
m i g u n e ɹ u	m i g u n e ɹ u
k e n i p o ɹ u	k e n i p o ɹ u
n e L i m i ɹ u	n e ɹ i m i ɹ u
g o p e g i ɹ u	g o p e g i ɹ u
d i k u b u l i	d i k u b u l i
g i d e p o l i	g i d e p o l i
b e L e g e ɹ u	b e ɹ e g e ɹ u
p u L i t u l i	p u l i t u l i
g i L u g i l i	g i l u g i l i
t i L e p e l i	t i l e p e l i
n i m i p u ɹ u	n i m i p u ɹ u
g i n o p i l i	g i n o p i l i
n o L u t o ɹ u	n o ɹ u t o ɹ u
k u b o k u l i	k u b o k u l i
d i L i g u ɹ u	d i ɹ i g u ɹ u
d e L e k i ɹ u	d e ɹ e k i ɹ u
p u L o t u ɹ u	p u ɹ o t u ɹ u
k i L i d o ɹ u	k i ɹ i d o ɹ u
b i n u g u l i	b i n u g u l i
k i L u p o ɹ u	k i ɹ u p o ɹ u
d i L i n e l i	d i l i n e l i
m e k i p u l i	m e k i p u l i
k e L i d o ɹ u	k e ɹ i d o ɹ u
p e L e d o ɹ u	p e ɹ e d o ɹ u
d i L i n e ɹ u	d i ɹ i n e ɹ u
d e n i t o ɹ u	d e n i t o ɹ u
m i L u t u ɹ u	m i ɹ u t u ɹ u
d u g e n u ɹ u	d u g e n u ɹ u
t u L i g o ɹ u	t u ɹ i g o ɹ u
m u L i k e ɹ u	m u ɹ i k e ɹ u
t i b u k o ɹ u	t i b u k o ɹ u
d i L i n i l i	d i l i n i l i
k u g i m u ɹ u	k u g i m u ɹ u
b u L o n e l i	b u l o n e l i
n o b i m i ɹ u	n o b i m i ɹ u
b o L u d e ɹ u	b o ɹ u d e ɹ u
p e L i m e ɹ u	p e ɹ i m e ɹ u
b u L i t o l i	b u l i t o l i
t o L o b e ɹ u	t o ɹ o b e ɹ u
n i L o m o ɹ u	n i ɹ o m o ɹ u
n u L i m u ɹ u	n u ɹ i m u ɹ u
t u L o d o l i	t u l o d o l i
d i g i m u ɹ u	d i g i m u ɹ u
g u b o g e ɹ u	g u b o g e ɹ u
t o p o t o ɹ u	t o p o t o ɹ u
t u t u m e ɹ u	t u t u m e ɹ u
g i L u m u l i	g i l u m u l i
b i L i p i ɹ u	b i ɹ i p i ɹ u
p u L o m e ɹ u	p u ɹ o m e ɹ u
m u L o d e l i	m u l o d e l i
m o n u n e ɹ u	m o n u n e ɹ u
k o L o d i l i	k o l o d i l i
n e b e b u l i	n e b e b u l i
t e L i b o l i	t e l i b o l i
t u t u m e l i	t u t u m e l i
d u p i n u l i	d u p i n u l i
g o L i b e ɹ u	g o ɹ i b e ɹ u
m e L u p i l i	m e l u p i l i
n i L o b e ɹ u	n i ɹ o b e ɹ u
t o L u d e l i	t o l u d e l i
g i d i p e l i	g i d i p e l i
g o d u d u ɹ u	g o d u d u ɹ u
k u L i k i l i	k u l i k i l i
d o d e n e l i	d o d e n e l i
b e L e p i ɹ u	b e ɹ e p i ɹ u
p i L i n u ɹ u	p i ɹ i n u ɹ u
t e L u n u l i	t e l u n u l i
n o L u t o l i	n o l u t o l i
b u L o n e ɹ u	b u ɹ o n e ɹ u
t i b u k o l i	t i b u k o l i
n o b i m i l i	n o b i m i l i
b e L u b i l i	b e l u b i l i
b i p e m i ɹ u	b i p e m i ɹ u
b i L i p i l i	b i l i p i l i
n u n u p u ɹ u	n u n u p u ɹ u
b e n o m o l i	b e n o m o l i
n e b e b u ɹ u	n e b e b u ɹ u
b u L u t o l i	b u l u t o l i
d i L u k i ɹ u	d i ɹ u k i ɹ u
k u g i m u l i	k u g i m u l i
b e L u b i ɹ u	b e ɹ u b i ɹ u
m o b i b u l i	m o b i b u l i
m i L u t u l i	m i l u t u l i
g i L o g i l i	g i l o g i l i
g o n o d e l i	g o n o d e l i
m i L i m u l i	m i l i m u l i
k i L i d o l i	k i l i d o l i
d i L o n e ɹ u	d i ɹ o n e ɹ u
k u g o p e ɹ u	k u g o p e ɹ u
g u b o g e l i	g u b o g e l i
g u L u b i l i	g u l u b i l i
m u k o b e ɹ u	m u k o b e ɹ u
g i L i m e l i	g i l i m e l i
m e p u k e ɹ u	m e p u k e ɹ u
g e L o m i l i	g e l o m i l i
n i n o g e l i	n i n o g e l i
d o p u p u ɹ u	d o p u p u ɹ u
b u L o b u ɹ u	b u ɹ o b u ɹ u
t u k e n u ɹ u	t u k e n u ɹ u
m e t u t o ɹ u	m e t u t o ɹ u
k u t o m o l i	k u t o m o l i
g o t u p e ɹ u	g o t u p e ɹ u
b e d o g i ɹ u	b e d o g i ɹ u
t u k e n u l i	t u k e n u l i
p o L o n u l i	p o l o n u l i
n i t e t i ɹ u	n i t e t i ɹ u
k o L i m e l i	k o l i m e l i
t e L o m u ɹ u	t e ɹ o m u ɹ u
k e b e g e ɹ u	k e b e g e ɹ u
g e L o m i ɹ u	g e ɹ o m i ɹ u
b e d i b o ɹ u	b e d i b o ɹ u
b u L u t o ɹ u	b u ɹ u t o ɹ u
m u m e k o l i	m u m e k o l i
d o d u m o l i	d o d u m o l i
b e L e p o l i	b e l e p o l i
b i p i d u l i	b i p i d u l i
k u L i k i ɹ u	k u ɹ i k i ɹ u
t e L u n u ɹ u	t e ɹ u n u ɹ u
t e L i n i ɹ u	t e ɹ i n i ɹ u
n i L o m o l i	n i l o m o l i
b o L o p o l i	b o l o p o l i
n u L u g e l i	n u l u g e l i
k e L i d o l i	k e l i d o l i
m i k e k e l i	m i k e k e l i
t u L e t i l i	t u l e t i l i
n u L i g i l i	n u l i g i l i
g i n o p i ɹ u	g i n o p i ɹ u
t u d u g i l i	t u d u g i l i
m i L i m u ɹ u	m i ɹ i m u ɹ u
d o d u b o ɹ u	d o d u b o ɹ u
g i L i t u ɹ u	g i ɹ i t u ɹ u
g o n o d e ɹ u	g o n o d e ɹ u
p u m e g o l i	p u m e g o l i
g u L u b i ɹ u	g u ɹ u b i ɹ u
g e L u k o ɹ u	g e ɹ u k o ɹ u
b i k e b e l i	b i k e b e l i
b e t o g e l i	b e t o g e l i
n u L i b o ɹ u	n u ɹ i b o ɹ u
p e L i m e l i	p e l i m e l i
b e L e g e l i	b e l e g e l i
d o d u m o ɹ u	d o d u m o ɹ u
n o L o m u l i	n o l o m u l i
m e t u t o l i	m e t u t o l i
p o L e n e l i	p o l e n e l i
t e m e d i ɹ u	t e m e d i ɹ u
b e g e t i l i	b e g e t i l i
p u m e g o ɹ u	p u m e g o ɹ u
t e L i b o ɹ u	t e ɹ i b o ɹ u
m u n e g o ɹ u	m u n e g o ɹ u
p o L e n e ɹ u	p o ɹ e n e ɹ u
k e p i k o l i	k e p i k o l i
t u m e t i l i	t u m e t i l i
m u L i k e l i	m u l i k e l i
g i d e k o l i	g i d e k o l i
n o L o g e l i	n o l o g e l i
d u b u d o l i	d u b u d o l i
b o L u d e l i	b o l u d e l i
p e L o p i l i	p e l o p i l i
b e n o m o ɹ u	b e n o m o ɹ u
n i g u n o l i	n i g u n o l i
d o p u p u l i	d o p u p u l i
p u L o t u l i	p u l o t u l i
d o L e t o l i	d o l e t o l i
t o L u d e ɹ u	t o ɹ u d e ɹ u
d o L e t o ɹ u	d o ɹ e t o ɹ u
m o p u d i ɹ u	m o p u d i ɹ u
n i m i p u l i	n i m i p u l i
g i p e d i l i	g i p e d i l i
t e m e d i l i	t e m e d i l i
t e t u d e ɹ u	t e t u d e ɹ u
g i p e d i ɹ u	g i p e d i ɹ u
t e L i b u ɹ u	t e ɹ i b u ɹ u
g o L e p e ɹ u	g o ɹ e p e ɹ u
d o p o m o ɹ u	d o p o m o ɹ u
p o L e k u ɹ u	p o ɹ e k u ɹ u
b u L o b u l i	b u l o b u l i
k i g e p o l i	k i g e p o l i
d u L e t i l i	d u l e t i l i
m e L e p e l i	m e l e p e l i
n u L i b o l i	n u l i b o l i
p e L o p o ɹ u	p e ɹ o p o ɹ u
n i n e d e l i	n i n e d e l i
b i L i p e ɹ u	b i ɹ i p e ɹ u
n e L i m i l i	n e l i m i l i
d i b i p e l i	d i b i p e l i
p e L o k o l i	p e l o k o l i
d o d e n e ɹ u	d o d e n e ɹ u
b i p e m i l i	b i p e m i l i
n i L u p e ɹ u	n i ɹ u p e ɹ u
g u L u p u l i	g u l u p u l i
m e n e m u l i	m e n e m u l i
d i k u b u ɹ u	d i k u b u ɹ u
d i g i m u l i	d i g i m u l i
m e p u k e l i	m e p u k e l i
t u L i g o l i	t u l i g o l i
p u L i t u ɹ u	p u ɹ i t u ɹ u
m e L u p i ɹ u	m e ɹ u p i ɹ u
p e L o p o l i	p e l o p o l i
t u d u k i ɹ u	t u d u k i ɹ u
g u n e t o ɹ u	g u n e t o ɹ u
b i L i p e l i	b i l i p e l i
m u m e k o ɹ u	m u m e k o ɹ u
n o L u d u l i	n o l u d u l i
d e n i t o l i	d e n i t o l i
d u L u k i ɹ u	d u ɹ u k i ɹ u
b o L o p o ɹ u	b o ɹ o p o ɹ u
b e L e p i l i	b e l e p i l i
k o p i g e l i	k o p i g e l i
k i g e p o ɹ u	k i g e p o ɹ u
n u L i m u l i	n u l i m u l i
b u L i t o ɹ u	b u ɹ i t o ɹ u
b e t o g e ɹ u	b e t o g e ɹ u
d i b i p e ɹ u	d i b i p e ɹ u
n i n e d e ɹ u	n i n e d e ɹ u
m u n e g o l i	m u n e g o l i
t e L i b u l i	t e l i b u l i
b e d o g i l i	b e d o g i l i
t e b e g o l i	t e b e g o l i
g o k o m u l i	g o k o m u l i
n u L i m u l i	n u l i m u l i
d i L o n e l i	d i l o n e l i
n u L i m u ɹ u	n u ɹ i m u ɹ u
t u d u k i l i	t u d u k i l i
m u k o b e l i	m u k o b e l i
p e L e d o l i	p e l e d o l i
b e p o g u ɹ u	b e p o g u ɹ u
m e L e p e ɹ u	m e ɹ e p e ɹ u
p o L i n o l i	p o l i n o l i
p o t i m o ɹ u	p o t i m o ɹ u
t e g u d e ɹ u	t e g u d e ɹ u
k u t o m o ɹ u	k u t o m o ɹ u
m e b u m e ɹ u	m e b u m e ɹ u
d u p i n u ɹ u	d u p i n u ɹ u
g i k i n o l i	g i k i n o l i
b e L e p o ɹ u	b e ɹ e p o ɹ u
n i L i g i l i	n i l i g i l i
b e g e t i ɹ u	b e g e t i ɹ u
g u L u p u ɹ u	g u ɹ u p u ɹ u
b u L o n i l i	b u l o n i l i
k e g e p o ɹ u	k e g e p o ɹ u
p i n e n o l i	p i n e n o l i
k o d u g i l i	k o d u g i l i
m o L i t e ɹ u	m o ɹ i t e ɹ u
g i k i n o ɹ u	g i k i n o ɹ u
g o d i t i ɹ u	g o d i t i ɹ u
m e b u m e l i	m e b u m e l i
p o t i m o l i	p o t i m o l i
m i g u n e l i	m i g u n e l i
b i p i d u ɹ u	b i p i d u ɹ u
m o b i b u ɹ u	m o b i b u ɹ u
d o d u b o l i	d o d u b o l i
d u L u k i l i	d u l u k i l i
b u k i k u ɹ u	b u k i k u ɹ u
n i L u p e l i	n i l u p e l i
m o n u n e l i	m o n u n e l i
g i L u m u ɹ u	g i ɹ u m u ɹ u
m o k o m i ɹ u	m o k o m i ɹ u
n u L o t e ɹ u	n u ɹ o t e ɹ u
b o t o p i ɹ u	b o t o p i ɹ u
m i L o m u ɹ u	m i ɹ o m u ɹ u
d u L i m i l i	d u l i m i l i
g o d u d u l i	g o d u d u l i
g i d e k o ɹ u	g i d e k o ɹ u
n u L o t e l i	n u l o t e l i
g i d i p e ɹ u	g i d i p e ɹ u
b e L u d e ɹ u	b e ɹ u d e ɹ u
n i L o b e l i	n i l o b e l i
t o L i m e l i	t o l i m e l i
p o L i n o ɹ u	p o ɹ i n o ɹ u
k o L o d i ɹ u	k o ɹ o d i ɹ u
p o L o n u ɹ u	p o ɹ o n u ɹ u
d u b u d o ɹ u	d u b u d o ɹ u
t e g u d e l i	t e g u d e l i
d o b e k i ɹ u	d o b e k i ɹ u
n i t e t i l i	n i t e t i l i
k o p i g e ɹ u	k o p i g e ɹ u
b e L u d e l i	b e l u d e l i
